ๆไปฌ็	ๆไปฌ
็ฑๆ่ฟๆฏ	่ฟๆฏ
็ธ่ฏ	็ธ่ฏ
ๆฏไปไปฌ	ไปไปฌ
่ฝ็ถ	่ฝ็ถ
ta	ta
hi	hi
iphone	phone
fuck	fuck
ๅฆๆ็ฑ	ๅฆๆ
kao	ka
tomorrow	tomorrow
iphon	upon
นน	นน
yes	yes
ฤใบร	ฤใ
ipho	who
we	we
ไปไปฌ	ไปไปฌ
hello	hello
billion	billion
